BBBBBBBBBBBBBBBBBBBBBB
BBBBBBBBBBBBBBBBBBBBBB
BBIGGGGGGGGGGGGGGGIBBB
BBIAAAAAAAkAAAAAfzIBBB
BBIAgAAAAAAAAAAAfAIBBB
BBIAAAa`_FGHcbeAAAIBBB
BBIAAAIAAUVWAAIAAAIBBB
BBIAAAIAAYSZAAIAAAIBBB
BBIAhAIAAYSZAAIAAAIBBB
BBIAAAEAAAAAAAEAAmIBBB
BBIKKKeKAAAAAAdAAAIBBB
BBFGGGGGGGGGGGGGGGHBBB
BBBBBBBBBBBBBBBBBBBBBB
BBBBBBBBBBBBBBBBBBBBBB
