BBBBBBBBBBBBBBBBBBBBBB
BBBBBBBBBBBBBBBBBBBBBB
BBBAAAAAAAAAAAAAAABBBB
BBB@@@{e@@bh@@{b@@BBBB
BBB@@@I@@|}~h@Eb@@BBBB
BBB@@@I@@FGH@@{b@fBBBB
BBB@@@I@@UVW@@I@heBBBB
BBB@@@I@{YSZ|~IheeBBBB
BBB@@@I@EYSZFHIefjBBBB
BBB@@@E@U\S]VWIieeBBBB
BBB@@@i@YSSSSZEekzBBBB
BBBBBBBBBBBBBBBBBBBBBB
BBBBBBBBBBBBBBBBBBBBBB
BBBBBBBBBBBBBBBBBBBBBB
