BBBBBBBBBBBBBBBBBBBBBBBBBBBBBBBBB
@@@@@@@@@@@@@@@@@@@@@@@@@@@@@@@@B
@@@@@@@@@@@@@@@@@@@@@@@@@@@@@@@@B
@@@@@@@@@@@@@@@AB@@@@@@@@@@@@@@@B
@@@@@@@@@@@@@@@AB@@@@@@@@@@@@@@@B
@@@@@@@@@@@@@@@AB@@@@@@@@@@@@@@@B
@@@@@@@@@@@@@@@AB@@@@@@@@@@@@@@@B