BBBBBBBBBBBBBBBBBBBBBB
BBBBBBBBBBBBBBBBBBBBBB
BBBAAAAAAAAAAAAAAABBBB
BBBb{@@@@@@@@@@@{nBBBB
BBB`I@UVW@@@UVW@IfBBBB
BBB@I@YS]VVV\SZ@I@BBBB
BBB@I@aYZ`zgYZb@I@BBBB
BBB@I@eYZ@^@YZ_@I@BBBB
BBB@I@U\]W@U\]W@I@BBBB
BBBcE@YSZ@@@YSZ@EdBBBB
BBB_@@@@@@@@@@@@@hBBBB
BBBBBBBBBBBBBBBBBBBBBB
BBBBBBBBBBBBBBBBBBBBBB
BBBBBBBBBBBBBBBBBBBBBB
