EEEEEEEEEEEEEEEEEEEEEE
EAAAAAAAAAAAAAAAAAAAAE
EAAAAAAAAAAAAAEEEAAAAE
EAAAAAAAAAAAAAASEAAAAE
EAAAAAAAAAAAAAASEAAAAE
EAAAAAAAAAAAAAASEAAAAE
EAAAAAAA__A_AAASEAAAAE
EAAAAAAAAAAAAAEEEAAAAE
EAEEAAAAAAAAAAAAAAAAAE
EAEEAAAAAAAAAAAAAAhAAE
EAEEAAAAAEEEEEAAAAmAAE
EAEEAAAAAEEAAAAAAAhAAE
EAEEAAAAAEEAAAAAAAmAEE
EEEEEEEEEEEEEEEEEEEEEE