BBBBBBBBBBBBBBBBBBBBBB
BBBBBBBBBBBBBBBBBBBBBB
BBIGGGPGGGGGGGPGGGIBBB
BBI@@@I@@@b@@@E@@@IBBB
BBI@@@I@@@@f@@g@@@IBBB
BBI@@@I@@FGH@@E@@fIBBB
BBI@@@I@@UVW@@I@heIBBB
BBI@@@I@@YSZ@@IheeIBBB
BBI@@@I@EYSZEEIefjIBBB
BBI@@@E@U\E]VWIieeIBBB
BBI@@@i@YSSSSZIekzIBBB
BBFGGGGGGGGGGGGGGGHBBB
BBBBBBBBBBBBBBBBBBBBBB
BBBBBBBBBBBBBBBBBBBBBB
