BBBBBBBBBBBBBBBBBBBBBB
BBBBBBBBBBBBBBBBBBBBBB
BBBAAAAAAAAAAAAAAABBBB
BBB@@^@@@`@@@a@^@fBBBB
BBB_cb{d`rBBBB
BBBxTxTxTxExTxTxTxBBBB
BBBq`{i{eaBBBB
BBBwTwTwEwTwEwTwTwBBBB
BBBa{@h@{pBBBB
BBBvTvEvTvTvTvEvTvBBBB
BBB^z_@@@@l@@`@@@@BBBB
BBBBBBBBBBBBBBBBBBBBBB
BBBBBBBBBBBBBBBBBBBBBB
BBBBBBBBBBBBBBBBBBBBBB
