BBBBBBBBBBBBBBBBBBBBBB
BBBBBBBBBBBBBBBBBBBBBB
BBBAAAAAAAAAAAAAAABBBB
BBB@{A|}}}}}}}~j@pBBBB
BBB@IqJKKKKGGGHd@eBBBB
BBB@I@JKKKO}}}~@bbBBBB
BBB@I@JKGGGGGGH@@BBBB
BBB@I@JOz}}}}}~v@@BBBB
BBB@I@JKKKKKKKL@@@BBBB
BBB@E@FGGGGGGGH@@BBBB
BBB@@@@@@@@@@@@w@@BBBB
BBBBBBBBBBBBBBBBBBBBBB
BBBBBBBBBBBBBBBBBBBBBB
BBBBBBBBBBBBBBBBBBBBBB
