BBBBBBBBBBBBBBBBBBBBBB
BBBBBBBBBBBBBBBBBBBBBB
BBBAAAAAAAAAAAAAAABBBB
BBBUVVVVW{@{UVVVVWBBBB
BBBYSSSSZI@IYSSSSZBBBB
BBBbhiefdIqIcecdhjBBBB
BBB@@@@@@EE@@@@nmBBBB
BBB@|}}}}~w|}}}}~lBBBB
BBB@JKKKKKKKKKKKLBBBB
BBB@FGGGGGGGGGGGHvBBBB
BBB@@@@@p@@@@@@z@@BBBB
BBBBBBBBBBBBBBBBBBBBBB
BBBBBBBBBBBBBBBBBBBBBB
BBBBBBBBBBBBBBBBBBBBBB
