BBBBBBBBBBBBBBBBBBBBBB
BBBBBBBBBBBBBBBBBBBBBB
BBIGGGPGGGGGGGPGGGIBBB
BBIAAAIAAAbAAAEAAAIBBB
BBIAAAIAAAAfAAgAAAIBBB
BBIAAAIAAFGHAAEAAfIBBB
BBIAAAIAAUVWAAIAheIBBB
BBIAAAIAAYSZAAIheeIBBB
BBIAAAIAEYSZEEIefjIBBB
BBIAAAEAU\E]VWIieeIBBB
BBIAAAiAYSSSSZIekzIBBB
BBFGGGGGGGGGGGGGGGHBBB
BBBBBBBBBBBBBBBBBBBBBB
BBBBBBBBBBBBBBBBBBBBBB
