BBBBBBBBBBBBBBBBBBBBBB
BBBBBBBBBBBBBBBBBBBBBB
BBBAAAAAAAAAAAAAAABBBB
BBB@{A|}}}}}}}~j@pBBBB
BBB@IqJKKK£GGGHd@eBBBB
BBB@I@JKKKO}}}~@bbBBBB
BBB@I@J£GGGGGGH@@BBBB
BBB@I@JOz}}}}}~v@@BBBB
BBB@I@JKKKKKKKL@@@BBBB
BBB@E@FGGGGGGGH@@BBBB
BBB@@@@@@@@@@@@w@@BBBB
BBBBBBBBBBBBBBBBBBBBBB
BBBBBBBBBBBBBBBBBBBBBB
BBBBBBBBBBBBBBBBBBBBBB
