BBBBBBBBBBBBBBBBBBBBBB
BBBBBBBBBBBBBBBBBBBBBB
BBIGGGGGGGGGGGGGGGIBBB
BBI@@@@@@@k@@@@@fzIBBB
BBI@g@@@@@@@@@@@f@IBBB
BBI@@@a`_FGHcbe@@@IBBB
BBI@@@I@@UVW@@I@@@IBBB
BBI@@@I@@YSZ@@I@@@IBBB
BBI@h@I@@YSZ@@I@@@IBBB
BBI@@@E@@@@@@@E@@mIBBB
BBI@@@e@@@@@@@d@@@IBBB
BBFGGGGGGGGGGGGGGGHBBB
BBBBBBBBBBBBBBBBBBBBBB
BBBBBBBBBBBBBBBBBBBBBB
