EEEEEEEEEEEEEEEEEEEEEEEEEEEEEEEEE
AAAAAAAAAAAAAAAAAAAAAAAAAAAAAAAAE
AAAAAAAAAAAAAAAAAAAAAAAAAAAAAAAAE
AAAAAAAAAAAAAAASEAAAAAAAAAAAAAAAE
AAAAAAAAAAAAAAASEAAAAAAAAAAAAAAAE
AAAAAAAAAAAAAAASEAAAAAAAAAAAAAAAE
AAAAAAAAAAAAAAASEAAAAAAAAAAAAAAAE