BBBBBBBBBBBBBBBBBBBBBB
BBBBBBBBBBBBBBBBBBBBBB
BBBAAAAAAAAAAAAAAABBBB
BBBce``bed{e`aaeagBBBB
BBBe@@@@@`I@@@@@@@BBBB
BBBc@`__@_I@``_c`@BBBB
BBBe@_obc_I@`cmea@BBBB
BBBe@_`_b`E@`lon`@BBBB
BBBe@@@@@@@@c_k``@BBBB
BBBec_`bb`{`di`ze@BBBB
BBBh`bbfe`Eeece@@@BBBB
BBBBBBBBBBBBBBBBBBBBBB
BBBBBBBBBBBBBBBBBBBBBB
BBBBBBBBBBBBBBBBBBBBBB
