BBBBBBBBBBBBBBBBBBBBBB
BBBBBBBBBBBBBBBBBBBBBB
BBBAIAAAAIAIAAAAIABBBB
BBBmIc@arIzIq^@@IkBBBB
BBBoI@@@`I_I_T@aIhBBBB
BBBjId@@dIpI@@@@IfBBBB
BBBI@@@@IIe@UWIBBBB
BBBvId@@dIxIT@b@IvBBBB
BBB@I@@@@II@@@@I@BBBB
BBB@EW@UVEwEUW@UE@BBBB
BBB@@@@@@@@@@@@@@@BBBB
BBBBBBBBBBBBBBBBBBBBBB
BBBBBBBBBBBBBBBBBBBBBB
BBBBBBBBBBBBBBBBBBBBBB
