BBBBBBBBBBBBBBBBBBBBBB
BBBBBBBBBBBBBBBBBBBBBB
BBBAAAAAAAAAAAAAAABBBB
BBB@@@@@@@k@@@@cbzBBBB
BBB@g@@@@|}~@@@@f@BBBB
BBB@@@{`_FGHcb{@@@BBBB
BBB@@@I@@UVW@@I@@@BBBB
BBB@@@I@@YSZ@@I@@@BBBB
BBB@h@I@@YSZ@@I@@@BBBB
BBB@@@E@@@@@@@E@@mBBBB
BBB@@@e@@@@@@@d@@@BBBB
BBBBBBBBBBBBBBBBBBBBBB
BBBBBBBBBBBBBBBBBBBBBB
BBBBBBBBBBBBBBBBBBBBBB
