EEEEEEEEEEEEEEEEEEEEEE
EAAAAAAAAAAAAAAAAAAAAE
EAAAAAAAAAAAAAEEEAAAAE
EAAAAAAAAAAAAAASEAAAAE
EAAAAAAAAAAAAAASEAAAAE
EAAAAAAAAAAAAAASEAAAAE
EAAAAAAA__A_AAASEAAAAE
EAAAAAAAAAAAAAEEEAAAAE
EAEEAAAAAAAAAAAAAAAAAE
EAEEAAAAAAAAAAAAAAAAAE
EAEEAAAAAEEEEEAAAAAAAE
EAEEAAAAAEEAAAAAAAAAAE
EAEEAAAAAEEAAAAAAAAAEE
EEEEEEEEEEEEEEEEEEEEEE